F                                                            f                                     I
HF                                                                                                 I
AHF                                   EBBF       I   h             I      e  b   III               I
AAHF                          EBBBBBBBGAAD                                  III                    I
AAAHF              l         EGAAAAAAAAAAD               II           III             I          * I
AAAAHBBBBBBBBBBBBBBBBBBBBBBBBGAAAAAAAAAAAHBBBBBBBBBB   II  II    III                      I   I  III
